Urban Combat Simulation
MaxSteps =200
NumShells= 19
Rows = 10
Cols=16
################
#1     @     2 #
#   ##     ##  #
#   ##   @ ##  #
#              #
# 1  ##   ##  2#
#      @       #
#  ##      ##  #
#     ####     #
#2          1  #
################
Extra lines should be ignored
So should this one